R 1222 6633
NO ./assets/wood.XPm
SO ./assets/redbrick.xpm
WE ./assets/stone.xpm
EA ./assets/mossy.xpm
S ./assets/sp2.xpm

F 86,12,23
C 10,151	,0

111111111
100000001
100000001
100000001
1000N0001
111111111