R 1600 900
NO ./cubassets/wood.xpm
SO ./cubassets/redbrick.xpm
WE ./cubassets/stone.xpm
EA ./cubassets/mossy.xpm
HU ./cubassets/hud3.xpm
S ./cubassets/sp3.xpm
F 78, 12, 22
C 10,151,176

  111                                                    111111111111111111111111111111111111111111
  101                                                   10000000000000000000000000000000000000000011
  111                                                   100000000000000000000000000000000000000000011
                                                        1000000000000000000000000000000000000000000011
              1111111  111111111111111111111            10000000000000000000000000000000000000000000011
           1111100001  100011111000000001001            100000000000000000000000000000000000000000000011
        1111100000001  100000011110111111101            1000000000000000000000000000000000000000000000011
  1111111100000000001  10000000000011    101            10000000000000S00000000000000000000000000000000011
  1000000000000000001  10000000000111   11011111111     100000000000000000000000000000000000000000000000011
  1100000000000000001  10000000000001   11000000001     1000000000000000000000000000000000000000000000000011
  1111111111111111111  11111110111111   11111111101     10000000000000000000000000200000000000000000000000011
                            10001               101     100000000000000000000000021200000000000000000000000011
  11111111111111111     111110001111111111111   101111  1000000000000000000d00002111200000000000000000000000011
 111000000000000011    1100000000000000000001   100001  10000000000000000000000211 11200000000000000000000000011
  10000000000000001    1000000000000000000001   1100011 1000000000000000000c00211   11200000000000000000000000011
  11000000000000011    1100000000000111110001   1000001 10000000000000000000000211 11200000000000000000000000011
  1000000000000001      1000000000001   10001   1000001 10000000000000000000b0002111200000000000000000000000011
  11100000000000011111111000000000001   10001   110000111000000000000000000000a0021200000000000000000000000011
   1111000000000000001000000000000001   10001  11100000000000000000000000000000000200000000000000000000000011
   1100000000000000000000000001111111   11111  1000111110000000000000000000000000000000000000000000000000011
   11111000001100000000000000000001            10001   1100000000000002000000000000000000000000000000000011
 111000000000000000000000000001111111111111111110001    10000000000000200000000000000000000000000000000011
 111111000000000000000000000000000000000000000000001    1000000000000020000000000000000000000000000000011
     11111100000000000000000011111111111111111000001    100000000000002000000000000000000000000000000011
         1111110000000000111111            111111111    10000000000000000000000000000000000000000000011
             11111111111111                             1000000000000000000000000000000000000000000011
                                                        100000000000000000000000000000000000000000011
                                                        10000000000000000000000000000000000000000011
                                                        1111111111111111111111111111111111111111111