R    1600 900

NO ./assets/wood.xpm
SO ./assets/redbrick.xpm
WE ./assets/stone.xpm
EA ./assets/mossy.xpm
S ./assets/sp3.xpm
F 86,   12,   22
C 10,151,176
 
  111                                                   1111111111111111111111111111111111111111111
  101                                                   12000000000000000000000000000000000000000211
  111                                                   120000000000000000000000000000000000000000011
                                                        1111111111111111111111111111111110000000000011
              1111111  111111111111111111111                                            100000001111111
           1111100001  100011011000000001001                                            100000001
        1111100000001  100000011000111111101                                            100000001
  1111111100000000001  10000000000011    101                                            100000001111111111
  1000000000000000001  10000000000111   11011111111     111111111111111111111111111111111000000000000000211
  1100000000000000001  10000000000001   11000000001     1200000000000000000000000000000000000000000000000011
  1111111111111111111  11111110111111   11111111101     10000000000000000000000000000000000000000000000000011
                            10001               101     100000000000000000010000000000000000000000000000000011
  11111111111111111     111110001111111111111   101111  1000000000000000001110000000000000000001111111111111111
 111200000000000211    1120000000000000000021   100001  1000000000000000011 11000000000000000001
  10000000000000001    1000000000000000000001   1100011 100000000000000011   1100000000000000001  11111111111111
  11000000000000011    1100000000000111110001   1000001 1000000000000000011 11000000000000000001  12020202020021
  1000000000000001      1000000000001   10001   1000001 1000000000000000001110000000000000000001  10202020200001
  11100000000000011111111000000000001   10001   110000111000000000000000000000000010000000000001  120202020200011
   1111000000000000001000000000000001   12221  1110000000000000000000000000000000000000000000001  1020202020000011
   1100000000000000000000000001111111   11111  1000111111000000000000000000000000000000000000001  12020202020000011
   11111000001100000000000000000001            10001    1000000000000000000000000000000000000001  102020202000000011
 111000000000000000000000000001111111111111111110001    1111111111111111111111111111111000000001  1202020202000000011
 111111000000000000000000000000000000000000000000001    1000000000000000000000000000000000000001  111111111111110000111
     11111100000000000000000000000000000000000000001    1000000000000000000000000000000000000021               110000111
         1111112000000002111111111111100011111111111    10000000000000111111111111111111111111111111111         11100001
             11111111111111          10001           1111000000000000010000000000000000000000000000011           1100001
                                     10001          1100000000000000001000000000000000000000000000011            1100001
                                     10001         1100000000000000000100000000000000000000000000211             1100001
                                     10001        1100001111111111111111000001111111100000001111111             11000011
           1111111111                100011111111110000011             1000001      1100000011                 11000011
          112000000211               10000000000000000211              1000001       1100000011               11000011
         11000000000011              1000000021111111111               1000001        1100000011             11000011
        1100000000000011111111111111110000000211111111111111111111111111000001         1100000011           11000011
       11200000000000000000000000000000000000000000000000000000000000000000001          110000001111111111111000011
       11000000E00000000000000000000000000000000000000000000000000000000000001           1100000000000000000000011
       11200000000000000000000000000000000000000000000000000000000000000000021            11000000000000000000011
        1100000000000011111111111111111111111111111111111111111111111111111111             112000000000000000211
         11000000000011                                                                     1111111111111111111
          112000000211
           1111111111