R 1222 6633
NO ./assets/wood.XPm
SO ./assets/redbrick.xpm
WE ./assets/stone.xpm
EA ./assets/mossy.xpm
S ./assets/sp2.xpm

F 86,12,23
C 10,151	,0


                                 111
                                 101111111
                      11111111111100000001
                      10000000111101111111
1111111111111111111   10011110111101
100000000000000000111110011 100N0001
100001111111111100000000001 11111111
111111         100000000001
               111111111111